########################################
#                                      #
#                                      #
#                                      #
#                                      #
#                   #                  #
#                   #                  #
#                   #                  #
#                   #                  #
#                   #                  #
#                   #                  #
#           ##################         #
#                   #                  #
#                   #                  #
#                   #                  #
#                   #                  #
#                   #                  #
#                                      #
#                                      #
#                                      #
#                                      #
#                                      #
########################################